

   MMMMMMMMMMMMMMMMMMMMMM1MMMMMMMMM
   M                          E   M
   M   PPP                        M
   MPPPPPP                        2
   M   PPP                        M
   MJ          B                  M
   MMMMMMMMMMMMMMMMM3MMMMMMMMMMMMMM
